Extracted from emacs with M-x describe-input-method.
!`	Â¡
--	â€“
?`	Â¿
\ 	Â 
\"	Ìˆ
\'	Ì
\,	â€¯
\-	Â­
\.	Ì‡
\/	â€Œ
\:	â€…
\;	â€„
\=	Ì„
\H	Ì‹
\L	Å
\O	Ã˜
\P	Â¶
\S	Â§
\^	Ì‚
\`	Ì€
\b	Ì±
\c	Ì§
\d	Ì£
\i	Ä±
\k	Ì¨
\l	Å‚
\o	Ã¸
\u	Ì†
\v	ÌŒ
\~	Ìƒ
^(	â½
^)	â¾
^+	âº
^-	â»
^0	â°
^1	Â¹
^2	Â²
^3	Â³
^4	â´
^5	âµ
^6	â¶
^7	â·
^8	â¸
^9	â¹
^=	â¼
^A	á´¬
^B	á´®
^D	á´°
^E	á´±
^G	á´³
^H	á´´
^I	á´µ
^J	á´¶
^K	á´·
^L	á´¸
^M	á´¹
^N	á´º
^O	á´¼
^P	á´¾
^R	á´¿
^T	áµ€
^U	áµ
^V	â±½
^W	áµ‚
^a	áµƒ
^b	áµ‡
^c	á¶œ
^d	áµˆ
^e	áµ‰
^f	á¶ 
^g	áµ
^h	Ê°
^i	â±
^j	Ê²
^k	áµ
^l	Ë¡
^m	áµ
^n	â¿
^o	áµ’
^p	áµ–
^r	Ê³
^s	Ë¢
^t	áµ—
^u	áµ˜
^v	áµ›
^w	Ê·
^x	Ë£
^y	Ê¸
^z	á¶»
_(	â‚
_)	â‚
_+	â‚Š
_-	â‚‹
_0	â‚€
_1	â‚
_2	â‚‚
_3	â‚ƒ
_4	â‚„
_5	â‚…
_6	â‚†
_7	â‚‡
_8	â‚ˆ
_9	â‚‰
_=	â‚Œ
_a	â‚
_e	â‚‘
_h	â‚•
_i	áµ¢
_j	â±¼
_k	â‚–
_l	â‚—
_m	â‚˜
_n	â‚™
_o	â‚’
_p	â‚š
_r	áµ£
_s	â‚›
_t	â‚œ
_u	áµ¤
_v	áµ¥
_x	â‚“
---	â€”
\"'	â€œ
\"<	Â«
\">	Â»
\"A	Ã„
\"E	Ã‹
\"H	á¸¦
\"I	Ã
\"O	Ã–
\"U	Ãœ
\"W	áº„
\"X	áºŒ
\"Y	Å¸
\"`	â€
\"a	Ã¤
\"e	Ã«
\"h	á¸§
\"i	Ã¯
\"o	Ã¶
\"t	áº—
\"u	Ã¼
\"w	áº…
\"x	áº
\"y	Ã¿
\'A	Ã
\'C	Ä†
\'E	Ã‰
\'G	Ç´
\'I	Ã
\'K	á¸°
\'L	Ä¹
\'M	á¸¾
\'N	Åƒ
\'O	Ã“
\'P	á¹”
\'R	Å”
\'S	Åš
\'U	Ãš
\'W	áº‚
\'Y	Ã
\'Z	Å¹
\'a	Ã¡
\'c	Ä‡
\'e	Ã©
\'g	Çµ
\'i	Ã­
\'k	á¸±
\'l	Äº
\'m	á¸¿
\'n	Å„
\'o	Ã³
\'p	á¹•
\'r	Å•
\'s	Å›
\'u	Ãº
\'w	áºƒ
\'y	Ã½
\'z	Åº
\.A	È¦
\.B	á¸‚
\.C	ÄŠ
\.D	á¸Š
\.E	Ä–
\.F	á¸
\.G	Ä 
\.H	á¸¢
\.I	Ä°
\.M	á¹€
\.N	á¹„
\.O	È®
\.P	á¹–
\.R	á¹˜
\.S	á¹ 
\.T	á¹ª
\.W	áº†
\.X	áºŠ
\.Y	áº
\.Z	Å»
\.a	È§
\.b	á¸ƒ
\.c	Ä‹
\.d	á¸‹
\.e	Ä—
\.f	á¸Ÿ
\.g	Ä¡
\.h	á¸£
\.m	á¹
\.n	á¹…
\.o	È¯
\.p	á¹—
\.r	á¹™
\.s	á¹¡
\.t	á¹«
\.w	áº‡
\.x	áº‹
\.y	áº
\.z	Å¼
\=A	Ä€
\=E	Ä’
\=G	á¸ 
\=I	Äª
\=O	ÅŒ
\=U	Åª
\=Y	È²
\=a	Ä
\=e	Ä“
\=g	á¸¡
\=i	Ä«
\=o	Å
\=u	Å«
\=y	È³
\AA	Ã…
\AE	Ã†
\DH	Ã
\HO	Å
\HU	Å°
\Ho	Å‘
\Hu	Å±
\Im	â„‘
\Ll	â‹˜
\Mu	Îœ
\Nu	Î
\OE	Å’
\Pi	Î 
\Re	â„œ
\TH	Ã
\Uo	Å‘
\Xi	Î
\^A	Ã‚
\^C	Äˆ
\^E	ÃŠ
\^G	Äœ
\^H	Ä¤
\^I	Ã
\^J	Ä´
\^O	Ã”
\^S	Åœ
\^U	Ã›
\^W	Å´
\^Y	Å¶
\^Z	áº
\^a	Ã¢
\^c	Ä‰
\^e	Ãª
\^g	Ä
\^h	Ä¥
\^i	Ã®
\^j	Äµ
\^o	Ã´
\^s	Å
\^u	Ã»
\^w	Åµ
\^y	Å·
\^z	áº‘
\`A	Ã€
\`E	Ãˆ
\`I	ÃŒ
\`N	Ç¸
\`O	Ã’
\`U	Ã™
\`W	áº€
\`Y	á»²
\`a	Ã 
\`e	Ã¨
\`i	Ã¬
\`n	Ç¹
\`o	Ã²
\`u	Ã¹
\`w	áº
\`y	á»³
\aa	Ã¥
\ae	Ã¦
\cC	Ã‡
\cD	á¸
\cE	È¨
\cG	Ä¢
\cH	á¸¨
\cK	Ä¶
\cL	Ä»
\cN	Å…
\cR	Å–
\cS	Å
\cT	Å¢
\cc	Ã§
\cd	á¸‘
\ce	È©
\cg	Ä£
\ch	á¸©
\ck	Ä·
\cl	Ä¼
\cn	Å†
\cr	Å—
\cs	ÅŸ
\ct	Å£
\dh	Ã°
\ge	â‰¥
\gg	â‰«
\in	âˆˆ
\kA	Ä„
\kE	Ä˜
\kI	Ä®
\kO	Çª
\kU	Å²
\ka	Ä…
\ke	Ä™
\ki	Ä¯
\ko	Ç«
\ku	Å³
\le	â‰¤
\ll	â‰ª
\lq	â€˜
\mp	âˆ“
\mu	Î¼
\ne	â‰ 
\ni	âˆ‹
\nu	Î½
\oe	Å“
\pi	Ï€
\pm	Â±
\rq	â€™
\ss	ÃŸ
\th	Ã¾
\to	â†’
\uA	Ä‚
\uE	Ä”
\uG	Ä
\uI	Ä¬
\uO	Å
\uU	Å¬
\ua	Äƒ
\ue	Ä•
\ug	ÄŸ
\ui	Ä­
\uo	Å
\uu	Å­
\vA	Ç
\vC	ÄŒ
\vD	Ä
\vE	Äš
\vG	Ç¦
\vH	È
\vI	Ç
\vK	Ç¨
\vL	Ä½
\vN	Å‡
\vO	Ç‘
\vR	Å˜
\vS	Å 
\vT	Å¤
\vU	Ç“
\vZ	Å½
\va	Ç
\vc	Ä
\vd	Ä
\ve	Ä›
\vg	Ç§
\vh	ÈŸ
\vi	Ç
\vj	Ç°
\vk	Ç©
\vl	Ä¾
\vn	Åˆ
\vo	Ç’
\vr	Å™
\vs	Å¡
\vt	Å¥
\vu	Ç”
\vz	Å¾
\wp	â„˜
\wr	â‰€
\xi	Î¾
\~A	Ãƒ
\~E	áº¼
\~I	Ä¨
\~N	Ã‘
\~O	Ã•
\~U	Å¨
\~V	á¹¼
\~Y	á»¸
\~a	Ã£
\~e	áº½
\~i	Ä©
\~n	Ã±
\~o	Ãµ
\~u	Å©
\~v	á¹½
\~y	á»¹
^o_	Âº
$^1$	Â¹
$^2$	Â²
$^3$	Â³
$^a$	Âª
$^o$	Âº
\"{}	Â¨
\'\O	Ç¾
\'\o	Ç¿
\'{}	Â´
\.{}	Ë™
\={}	Â¯
\Box	â–¡
\Cap	â‹’
\Chi	Î§
\Cup	â‹“
\Dei	Ï®
\Eta	Î—
\Fei	Ï¤
\H{}	Ë
\Lsh	â†°
\Phi	Î¦
\Psi	Î¨
\Rho	Î¡
\Rsh	â†±
\San	Ïº
\Sho	Ï·
\Tau	Î¤
\Yot	Í¿
\ast	âˆ—
\bot	âŠ¥
\cap	âˆ©
\chi	Ï‡
\cup	âˆª
\c{}	Â¸
\dag	â€ 
\dei	Ï¯
\div	Ã·
\ell	â„“
\eta	Î·
\fei	Ï¥
\flq	â€¹
\frq	â€º
\geq	â‰¥
\ggg	â‹™
\glq	â€š
\grq	â€˜
\iff	â‡”
\int	âˆ«
\kip	â‚­
\k{}	Ë›
\ldq	â€œ
\leq	â‰¤
\lhd	â—
\mho	â„§
\mid	âˆ£
\neg	Â¬
\neq	â‰ 
\not	Ì¸
\ohm	â„¦
\par	â€©
\per	â…Œ
\phi	Ï†
\psi	Ïˆ
\qed	âˆ
\rdq	â€
\rhd	â–·
\rho	Ï
\san	Ï»
\sbs	ï¹¨
\sho	Ï¸
\sim	âˆ¼
\sum	âˆ‘
\tau	Ï„
\top	âŠ¤
\u{}	Ë˜
\vee	âˆ¨
\v{}	Ë‡
\won	â‚©
\yen	Â¥
\~{}	Ëœ
^\Ae	á´­
^\Ou	á´½
$\pm$	Â±
\"\'I	á¸®
\"\'U	Ç—
\"\'i	á¸¯
\"\'u	Ç˜
\"\=A	Ç
\"\=O	Èª
\"\=U	Ç•
\"\=a	ÇŸ
\"\=o	È«
\"\=u	Ç–
\"\`U	Ç›
\"\`u	Çœ
\"\vU	Ç™
\"\vu	Çš
\"{A}	Ã„
\"{E}	Ã‹
\"{H}	á¸¦
\"{I}	Ã
\"{O}	Ã–
\"{U}	Ãœ
\"{W}	áº„
\"{X}	áºŒ
\"{Y}	Å¸
\"{a}	Ã¤
\"{e}	Ã«
\"{h}	á¸§
\"{i}	Ã¯
\"{o}	Ã¶
\"{t}	áº—
\"{u}	Ã¼
\"{w}	áº…
\"{x}	áº
\"{y}	Ã¿
\'\.S	á¹¤
\'\.s	á¹¥
\'\AE	Ç¼
\'\ae	Ç½
\'{A}	Ã
\'{C}	Ä†
\'{E}	Ã‰
\'{G}	Ç´
\'{I}	Ã
\'{K}	á¸°
\'{L}	Ä¹
\'{M}	á¸¾
\'{N}	Åƒ
\'{O}	Ã“
\'{P}	á¹”
\'{R}	Å”
\'{S}	Åš
\'{U}	Ãš
\'{W}	áº‚
\'{Y}	Ã
\'{Z}	Å¹
\'{a}	Ã¡
\'{c}	Ä‡
\'{e}	Ã©
\'{g}	Çµ
\'{i}	Ã­
\'{k}	á¸±
\'{l}	Äº
\'{m}	á¸¿
\'{n}	Å„
\'{o}	Ã³
\'{p}	á¹•
\'{r}	Å•
\'{s}	Å›
\'{u}	Ãº
\'{w}	áºƒ
\'{y}	Ã½
\'{z}	Åº
\.\=A	Ç 
\.\=O	È°
\.\=a	Ç¡
\.\=o	È±
\.{A}	È¦
\.{B}	á¸‚
\.{C}	ÄŠ
\.{D}	á¸Š
\.{E}	Ä–
\.{F}	á¸
\.{G}	Ä 
\.{H}	á¸¢
\.{I}	Ä°
\.{M}	á¹€
\.{N}	á¹„
\.{O}	È®
\.{P}	á¹–
\.{R}	á¹˜
\.{S}	á¹ 
\.{T}	á¹ª
\.{W}	áº†
\.{X}	áºŠ
\.{Y}	áº
\.{Z}	Å»
\.{a}	È§
\.{b}	á¸ƒ
\.{c}	Ä‹
\.{d}	á¸‹
\.{e}	Ä—
\.{f}	á¸Ÿ
\.{g}	Ä¡
\.{h}	á¸£
\.{m}	á¹
\.{n}	á¹…
\.{o}	È¯
\.{p}	á¹—
\.{r}	á¹™
\.{s}	á¹¡
\.{t}	á¹«
\.{w}	áº‡
\.{x}	áº‹
\.{y}	áº
\.{z}	Å¼
\=\"U	á¹º
\=\"u	á¹»
\=\'E	á¸–
\=\'O	á¹’
\=\'e	á¸—
\=\'o	á¹“
\=\AE	Ç¢
\=\`E	á¸”
\=\`O	á¹
\=\`e	á¸•
\=\`o	á¹‘
\=\ae	Ç£
\={A}	Ä€
\={E}	Ä’
\={G}	á¸ 
\={I}	Äª
\={O}	ÅŒ
\={U}	Åª
\={Y}	È²
\={a}	Ä
\={e}	Ä“
\={g}	á¸¡
\={i}	Ä«
\={o}	Å
\={u}	Å«
\={y}	È³
\Beta	Î’
\Heta	Í°
\Hori	Ï¨
\H{O}	Å
\H{U}	Å°
\H{o}	Å‘
\H{u}	Å±
\Iota	Î™
\Join	â‹ˆ
\Khei	Ï¦
\Shei	Ï¢
\U{o}	Å‘
\Vert	â€–
\Zeta	Î–
\^\'A	áº¤
\^\'E	áº¾
\^\'O	á»
\^\'a	áº¥
\^\'e	áº¿
\^\'o	á»‘
\^\`A	áº¦
\^\`E	á»€
\^\`O	á»’
\^\`a	áº§
\^\`e	á»
\^\`o	á»“
\^\~A	áºª
\^\~E	á»„
\^\~O	á»–
\^\~a	áº«
\^\~e	á»…
\^\~o	á»—
\^{A}	Ã‚
\^{C}	Äˆ
\^{E}	ÃŠ
\^{G}	Äœ
\^{H}	Ä¤
\^{I}	Ã
\^{J}	Ä´
\^{O}	Ã”
\^{S}	Åœ
\^{U}	Ã›
\^{W}	Å´
\^{Y}	Å¶
\^{Z}	áº
\^{a}	Ã¢
\^{c}	Ä‰
\^{e}	Ãª
\^{g}	Ä
\^{h}	Ä¥
\^{i}	Ã®
\^{j}	Äµ
\^{o}	Ã´
\^{s}	Å
\^{u}	Ã»
\^{w}	Åµ
\^{y}	Å·
\^{z}	áº‘
\`{A}	Ã€
\`{E}	Ãˆ
\`{I}	ÃŒ
\`{N}	Ç¸
\`{O}	Ã’
\`{U}	Ã™
\`{W}	áº€
\`{Y}	á»²
\`{a}	Ã 
\`{e}	Ã¨
\`{i}	Ã¬
\`{n}	Ç¹
\`{o}	Ã²
\`{u}	Ã¹
\`{w}	áº
\`{y}	á»³
\beta	Î²
\beth	â„¶
\c\'C	á¸ˆ
\c\'c	á¸‰
\c\uE	á¸œ
\c\ue	á¸
\cdot	Â·
\cedi	â‚µ
\cent	Â¢
\circ	âˆ˜
\cong	â‰…
\c{C}	Ã‡
\c{D}	á¸
\c{E}	È¨
\c{G}	Ä¢
\c{H}	á¸¨
\c{K}	Ä¶
\c{L}	Ä»
\c{N}	Å…
\c{R}	Å–
\c{S}	Å
\c{T}	Å¢
\c{c}	Ã§
\c{d}	á¸‘
\c{e}	È©
\c{g}	Ä£
\c{h}	á¸©
\c{k}	Ä·
\c{l}	Ä¼
\c{n}	Å†
\c{r}	Å—
\c{s}	ÅŸ
\c{t}	Å£
\d\.S	á¹¨
\d\.s	á¹©
\d\=L	á¸¸
\d\=R	á¹œ
\d\=l	á¸¹
\d\=r	á¹
\ddag	â€¡
\defs	â‰™
\dong	â‚«
\d{A}	áº 
\d{B}	á¸„
\d{D}	á¸Œ
\d{E}	áº¸
\d{H}	á¸¤
\d{I}	á»Š
\d{K}	á¸²
\d{L}	á¸¶
\d{M}	á¹‚
\d{N}	á¹†
\d{O}	á»Œ
\d{R}	á¹š
\d{S}	á¹¢
\d{T}	á¹¬
\d{U}	á»¤
\d{V}	á¹¾
\d{W}	áºˆ
\d{Y}	á»´
\d{Z}	áº’
\d{a}	áº¡
\d{b}	á¸…
\d{d}	á¸
\d{e}	áº¹
\d{h}	á¸¥
\d{i}	á»‹
\d{k}	á¸³
\d{l}	á¸·
\d{m}	á¹ƒ
\d{n}	á¹‡
\d{o}	á»
\d{r}	á¹›
\d{s}	á¹£
\d{t}	á¹­
\d{u}	á»¥
\d{v}	á¹¿
\d{w}	áº‰
\d{y}	á»µ
\d{z}	áº“
\euro	â‚¬
\flat	â™­
\flqq	Â«
\frqq	Â»
\geqq	â‰§
\gets	â†
\glqq	â€
\gneq	â‰©
\grqq	â€œ
\hbar	â„
\heta	Í±
\hori	Ï©
\iota	Î¹
\k\=O	Ç¬
\k\=o	Ç­
\khei	Ï§
\k{A}	Ä„
\k{E}	Ä˜
\k{I}	Ä®
\k{O}	Çª
\k{U}	Å²
\k{a}	Ä…
\k{e}	Ä™
\k{i}	Ä¯
\k{o}	Ç«
\k{u}	Å³
\lari	â‚¾
\leqq	â‰¦
\lira	â‚¤
\lneq	â‰¨
\lnot	Â¬
\male	â™‚
\mill	â‚¥
\ngeq	â‰±
\ngtr	â‰¯
\nleq	â‰°
\nmid	âˆ¤
\nsim	â‰
\odot	âŠ™
\oint	âˆ®
\perp	âŠ¥
\peso	â‚±
\prec	â‰º
\prod	âˆ
\quad	â€
\rial	ï·¼
\shei	Ï£
\star	â‹†
\succ	â‰»
\surd	âˆš
\u\'A	áº®
\u\'a	áº¯
\u\`A	áº°
\u\`a	áº±
\u\~A	áº´
\u\~a	áºµ
\u{A}	Ä‚
\u{E}	Ä”
\u{G}	Ä
\u{I}	Ä¬
\u{O}	Å
\u{U}	Å¬
\u{a}	Äƒ
\u{e}	Ä•
\u{g}	ÄŸ
\u{i}	Ä­
\u{o}	Å
\u{u}	Å­
\v\.S	á¹¦
\v\.s	á¹§
\v{A}	Ç
\v{C}	ÄŒ
\v{D}	Ä
\v{E}	Äš
\v{G}	Ç¦
\v{H}	È
\v{I}	Ç
\v{K}	Ç¨
\v{L}	Ä½
\v{N}	Å‡
\v{O}	Ç‘
\v{R}	Å˜
\v{S}	Å 
\v{T}	Å¤
\v{U}	Ç“
\v{Z}	Å½
\v{a}	Ç
\v{c}	Ä
\v{d}	Ä
\v{e}	Ä›
\v{g}	Ç§
\v{h}	ÈŸ
\v{i}	Ç
\v{j}	Ç°
\v{k}	Ç©
\v{l}	Ä¾
\v{n}	Åˆ
\v{o}	Ç’
\v{r}	Å™
\v{s}	Å¡
\v{t}	Å¥
\v{u}	Ç”
\v{z}	Å¾
\zeta	Î¶
\~\"O	á¹
\~\"o	á¹
\~\'O	á¹Œ
\~\'U	á¹¸
\~\'o	á¹
\~\'u	á¹¹
\~\=O	È¬
\~\=o	È­
\~{A}	Ãƒ
\~{E}	áº¼
\~{I}	Ä¨
\~{N}	Ã‘
\~{O}	Ã•
\~{U}	Å¨
\~{V}	á¹¼
\~{Y}	á»¸
\~{a}	Ã£
\~{e}	áº½
\~{i}	Ä©
\~{n}	Ã±
\~{o}	Ãµ
\~{u}	Å©
\~{v}	á¹½
\~{y}	á»¹
^\ain	áµœ
^\chi	áµ¡
^\eng	áµ‘
^\esh	á¶´
^\eth	á¶
^\ezh	á¶¾
^\phi	á¶²
^{SM}	â„ 
^{TM}	â„¢
$\div$	Ã·
\'{\O}	Ç¾
\'{\o}	Ç¿
\={\i}	Ä«
\Alpha	Î‘
\Delta	Î”
\Gamma	Î“
\Kappa	Îš
\Koppa	Ï
\Lamda	Î›
\Omega	Î©
\Sampi	Ï 
\Shima	Ï¬
\Sigma	Î£
\Theta	Î˜
\Vdash	âŠ©
\^{\j}	Äµ
\aleph	â„µ
\alpha	Î±
\amalg	âˆ
\angle	âˆ 
\asymp	â‰
\cdots	â‹¯
\colon	â‚¡
\dashv	âŠ£
\ddots	â‹±
\delta	Î´
\doteq	â‰
\equiv	â‰¡
\frac1	â…Ÿ
\frown	âŒ¢
\gamma	Î³
\gimel	â„·
\gneqq	â‰©
\gnsim	â‹§
\imath	Ä±
\infty	âˆ
\kappa	Îº
\koppa	ÏŸ
\lamda	Î»
\lceil	âŒˆ
\ldata	ã€Š
\ldots	â€¦
\lneqq	â‰¨
\lnsim	â‹¦
\manat	â‚¼
\micro	Âµ
\minus	âˆ’
\nabla	âˆ‡
\naira	â‚¦
\ncong	â‰‡
\ngeqq	â‰±
\nleqq	â‰°
\nless	â‰®
\notin	âˆ‰
\nprec	âŠ€
\nsucc	âŠ
\omega	Ï‰
\oplus	âŠ•
\ounce	â„¥
\pound	Â£
\prime	â€²
\rceil	âŒ‰
\rdata	ã€‹
\ruble	â‚½
\rupee	â‚¨
\sampi	Ï¡
\sharp	â™¯
\shima	Ï­
\sigma	Ïƒ
\simeq	â‰ƒ
\smile	âŒ£
\sqcap	âŠ“
\sqcup	âŠ”
\tenge	â‚¸
\theta	Î¸
\times	Ã—
\uplus	âŠ
\u{\i}	Ä­
\vDash	âŠ¨
\varpi	Ï–
\vdash	âŠ¢
\vdots	â‹®
\v{\i}	Ç
\v{\j}	Ç°
\wedge	âˆ§
\~{\i}	Ä©
^\beta	áµ
^\heng	ê­œ
^\iota	á¶¥
^{TEL}	â„¡
$\cdot$	Â·
\"\'{I}	á¸®
\"\'{U}	Ç—
\"\'{i}	á¸¯
\"\'{u}	Ç˜
\"\={A}	Ç
\"\={O}	Èª
\"\={U}	Ç•
\"\={a}	ÇŸ
\"\={o}	È«
\"\={u}	Ç–
\"\`{U}	Ç›
\"\`{u}	Çœ
\"\v{U}	Ç™
\"\v{u}	Çš
\'\.{S}	á¹¤
\'\.{s}	á¹¥
\'{\AE}	Ç¼
\'{\ae}	Ç½
\.\={A}	Ç 
\.\={O}	È°
\.\={a}	Ç¡
\.\={o}	È±
\=\"{U}	á¹º
\=\"{u}	á¹»
\=\'{E}	á¸–
\=\'{O}	á¹’
\=\'{e}	á¸—
\=\'{o}	á¹“
\=\`{E}	á¸”
\=\`{O}	á¹
\=\`{e}	á¸•
\=\`{o}	á¹‘
\={\AE}	Ç¢
\={\ae}	Ç£
\Bbb{N}	â„•
\Bbb{P}	â„™
\Bbb{R}	â„
\Bbb{Z}	â„¤
\Bumpeq	â‰
\Frowny	â˜¹
\Gangia	Ïª
\Lambda	Î›
\Letter	âœ‰
\Smiley	â˜º
\Stigma	Ïš
\Subset	â‹
\Supset	â‹‘
\Vvdash	âŠª
\^\'{A}	áº¤
\^\'{E}	áº¾
\^\'{O}	á»
\^\'{a}	áº¥
\^\'{e}	áº¿
\^\'{o}	á»‘
\^\`{A}	áº¦
\^\`{E}	á»€
\^\`{O}	á»’
\^\`{a}	áº§
\^\`{e}	á»
\^\`{o}	á»“
\^\d{A}	áº¬
\^\d{E}	á»†
\^\d{O}	á»˜
\^\d{a}	áº­
\^\d{e}	á»‡
\^\d{o}	á»™
\^\~{A}	áºª
\^\~{E}	á»„
\^\~{O}	á»–
\^\~{a}	áº«
\^\~{e}	á»…
\^\~{o}	á»—
\approx	â‰ˆ
\bigcap	â‹‚
\bigcup	â‹ƒ
\bigvee	â‹
\bowtie	â‹ˆ
\bullet	â€¢
\bumpeq	â‰
\c\'{C}	á¸ˆ
\c\'{c}	á¸‰
\c\u{E}	á¸œ
\c\u{e}	á¸
\circeq	â‰—
\coprod	âˆ
\d\.{S}	á¹¨
\d\.{s}	á¹©
\d\={L}	á¸¸
\d\={R}	á¹œ
\d\={l}	á¸¹
\d\={r}	á¹
\dagger	â€ 
\daleth	â„¸
\degree	Â°
\eqcirc	â‰–
\exists	âˆƒ
\female	â™€
\forall	âˆ€
\frac12	Â½
\frac13	â…“
\frac14	Â¼
\frac15	â…•
\frac16	â…™
\frac18	â…›
\frac23	â…”
\frac25	â…–
\frac34	Â¾
\frac35	â…—
\frac38	â…œ
\frac45	â…˜
\frac56	â…š
\frac58	â…
\frac78	â…
\gangia	Ï«
\gtrdot	â‹—
\gtrsim	â‰³
\k\={O}	Ç¬
\k\={o}	Ç­
\kelvin	â„ª
\lambda	Î»
\langle	âŸ¨
\lfloor	âŒŠ
\ltimes	â‹‰
\mapsto	â†¦
\models	âŠ§
\nVDash	âŠ¯
\nVdash	âŠ®
\nequiv	â‰¢
\nsimeq	â‰„
\numero	â„–
\nvDash	âŠ­
\nvdash	âŠ¬
\ominus	âŠ–
\oslash	âŠ˜
\otimes	âŠ—
\permil	â€°
\peseta	â‚§
\pounds	Â£
\preceq	â‰¼
\propto	âˆ
\rangle	âŸ©
\rfloor	âŒ‹
\rtimes	â‹Š
\square	â–¡
\stigma	Ï›
\subset	âŠ‚
\succeq	â‰½
\supset	âŠƒ
\textmu	Âµ
\tugrik	â‚®
\u\'{A}	áº®
\u\'{a}	áº¯
\u\`{A}	áº°
\u\`{a}	áº±
\u\d{A}	áº¶
\u\d{a}	áº·
\u\~{A}	áº´
\u\~{a}	áºµ
\v\.{S}	á¹¦
\v\.{s}	á¹§
\varkai	Ï—
\varphi	Ï•
\varrho	Ï±
\veebar	âŠ»
\~\"{O}	á¹
\~\"{o}	á¹
\~\'{O}	á¹Œ
\~\'{U}	á¹¸
\~\'{o}	á¹
\~\'{u}	á¹¹
\~\={O}	È¬
\~\={o}	È­
^\alpha	áµ…
^\delta	áµŸ
^\gamma	Ë 
^\schwa	áµŠ
^\theta	á¶¿
^\u bar	á¶¶
$\times$	Ã—
\Diamond	â—‡
\Digamma	Ïœ
\Epsilon	Î•
\Omicron	ÎŸ
\Uparrow	â‡‘
\Upsilon	Î¥
\afghani	Ø‹
\austral	â‚³
\backsim	âˆ½
\because	âˆµ
\between	â‰¬
\bigcirc	â—¯
\bigstar	â˜…
\boxplus	âŠ
\caution	â˜¡
\celsius	â„ƒ
\coloneq	â‰”
\ddagger	â€¡
\diamond	â‹„
\digamma	Ï
\dotplus	âˆ”
\drachma	â‚¯
\epsilon	Îµ
\eqcolon	â‰•
\gtrless	â‰·
\guarani	â‚²
\hryvnia	â‚´
\leadsto	â†
\lessdot	â‹–
\lessgtr	â‰¶
\lesssim	â‰²
\lozenge	âœ§
\maltese	âœ 
\napprox	â‰‰
\natural	â™®
\nearrow	â†—
\newline	â€¨
\nexists	âˆ„
\nomisma	ğ†
\npreceq	â‹ 
\nsubset	âŠ„
\nsucceq	â‹¡
\nsupset	âŠ…
\nwarrow	â†–
\omicron	Î¿
\partial	âˆ‚
\pilcrow	Â¶
\precsim	â‰¾
\searrow	â†˜
\section	Â§
\succsim	â‰¿
\swarrow	â†™
\textwon	â‚©
\uparrow	â†‘
\upsilon	Ï…
\varbeta	Ï
\warning	âš 
^\h hook	Ê±
^\open e	áµ‹
^\open o	áµ“
\angstrom	â„«
\approxeq	â‰Š
\backcong	â‰Œ
\barwedge	âŠ¼
\bigwedge	â‹€
\boxminus	âŠŸ
\boxtimes	âŠ 
\circledR	Â®
\circledS	â“ˆ
\clubsuit	â™£
\cruzeiro	â‚¢
\curlyvee	â‹
\currency	Â¤
\diameter	âŒ€
\division	Ã·
\doteqdot	â‰‘
\emptyset	âˆ…
\geqslant	â‰¥
\gnapprox	â‹§
\intercal	âŠº
\leqslant	â‰¤
\llcorner	âŒ
\lnapprox	â‹¦
\lrcorner	âŒŸ
\multimap	âŠ¸
\parallel	âˆ¥
\precnsim	â‹¨
\setminus	âˆ–
\shortmid	âˆ£
\spesmilo	â‚·
\sqsubset	âŠ
\sqsupset	âŠ
\subseteq	âŠ†
\succnsim	â‹©
\supseteq	âŠ‡
\textbaht	à¸¿
\textdied	âœ
\textlira	â‚¤
\textpeso	â‚±
\thicksim	âˆ¼
\triangle	â–µ
\ulcorner	âŒœ
\urcorner	âŒ
\varkappa	Ï°
\varprime	â€²
\varsigma	Ï‚
\vartheta	Ï‘
^\upsilon	á¶·
\Downarrow	â‡“
\Leftarrow	â‡
\backprime	â€µ
\backsimeq	â‹
\biohazard	â˜£
\centerdot	Â·
\checkmark	âœ“
\copyright	Â©
\dotsquare	âŠ¡
\downarrow	â†“
\facsimile	â„»
\gtrapprox	â‰³
\gtreqless	â‹›
\gvertneqq	â‰©
\heartsuit	â™¥
\lambdabar	Æ›
\leftarrow	â†
\lesseqgtr	â‹š
\llbracket	ã€š
\lvertneqq	â‰¨
\ngeqslant	â‰±
\nleqslant	â‰°
\nparallel	âˆ¦
\nshortmid	âˆ¤
\nsubseteq	âŠˆ
\nsupseteq	âŠ‰
\octagonal	ğŸ›‘
\paragraph	Â¶
\pitchfork	â‹”
\rrbracket	ã€›
\spadesuit	â™ 
\subseteqq	âŠ†
\subsetneq	âŠŠ
\supseteqq	âŠ‡
\supsetneq	âŠ‹
\telephone	â„¡
\textnaira	â‚¦
\therefore	âˆ´
\triangleq	â‰œ
\varpropto	âˆ
^\Barred B	á´¯
^\barred o	á¶±
^\script g	á¶¢
^\turned a	áµ„
^\turned h	á¶£
^\turned i	áµ
^\turned m	áµš
^\turned r	Ê´
^\turned v	á¶º
\Lleftarrow	â‡š
\Rightarrow	â‡’
\circledast	âŠ›
\complement	âˆ
\curlywedge	â‹
\eqslantgtr	â‹
\gtreqqless	â‹›
\lessapprox	â‰²
\lesseqqgtr	â‹š
\longmapsto	â†¦
\mathscr{I}	â„
\nLeftarrow	â‡
\nleftarrow	â†š
\nsubseteqq	âŠˆ
\nsupseteqq	âŠ‰
\precapprox	â‰¾
\prohibited	ğŸ›‡
\registered	Â®
\rightarrow	â†’
\smallamalg	âˆ
\smallsmile	âŒ£
\sqsubseteq	âŠ‘
\sqsupseteq	âŠ’
\subsetneqq	âŠŠ
\succapprox	â‰¿
\supsetneqq	âŠ‹
\textlquill	â…
\textnumero	â„–
\textrecipe	â„
\textrquill	â†
\upuparrows	â‡ˆ
^\capital i	á¶¦
^\capital l	á¶«
^\capital n	á¶°
^\capital u	á¶¸
^\greek phi	áµ 
^\turned ae	áµ†
\Rrightarrow	â‡›
\Updownarrow	â‡•
\backepsilon	âˆ
\blacksmiley	â˜»
\blacksquare	â–ª
\circledcirc	âŠš
\circleddash	âŠ
\curlyeqprec	â‹
\curlyeqsucc	â‹Ÿ
\curlypreceq	â‰¼
\diamondsuit	â™¢
\eqslantless	â‹œ
\nRightarrow	â‡
\nrightarrow	â†›
\ordfeminine	Âª
\partnership	ã‰
\precnapprox	â‹¨
\radioactive	â˜¢
\straightphi	Ï†
\succcurlyeq	â‰½
\succnapprox	â‹©
\thickapprox	â‰ˆ
\uncertainty	â¯‘
\updownarrow	â†•
^\Reversed E	á´²
^\Reversed N	á´»
^\sideways u	áµ™
^\top half o	áµ”
\blacklozenge	âœ¦
\construction	ğŸš§
\ordmasculine	Âº
\risingdotseq	â‰“
\textcircledP	â„—
\textdiscount	â’
\triangledown	â–¿
\triangleleft	â—ƒ
^\c with curl	á¶
^\greek gamma	áµ
^\h with hook	Ê±
^\ligature oe	êŸ¹
^\m with hook	á¶¬
^\s with hook	á¶³
^\v with hook	á¶¹
^\z with curl	á¶½
\Longleftarrow	â‡
\bigtriangleup	â–³
\blacktriangle	â–´
\divideontimes	â‹‡
\fallingdotseq	â‰’
\hookleftarrow	â†©
\leftarrowtail	â†¢
\leftharpoonup	â†¼
\longleftarrow	â†
\looparrowleft	â†«
\measuredangle	âˆ¡
\ntriangleleft	â‹ª
\shortparallel	âˆ¥
\smallsetminus	âˆ–
\textbigcircle	âƒ
\textestimated	â„®
\triangleright	â–¹
\upleftharpoon	â†¿
^\turned alpha	á¶›
\Leftrightarrow	â‡”
\Longrightarrow	â‡’
\curvearrowleft	â†¶
\downdownarrows	â‡Š
\hookrightarrow	â†ª
\leftleftarrows	â‡‡
\leftrightarrow	â†”
\leftthreetimes	â‹‹
\longrightarrow	â†’
\looparrowright	â†¬
\multiplication	Ã—
\nshortparallel	âˆ¦
\ntriangleright	â‹«
\rightarrowtail	â†£
\rightharpoonup	â‡€
\sphericalangle	âˆ¢
\textopenbullet	â—¦
\trianglelefteq	âŠ´
\uprightharpoon	â†¾
^\H With Stroke	êŸ¸
^\bottom half o	áµ•
^\i with stroke	á¶¤
^\turned open e	áµŒ
^\turned r hook	Êµ
\bigtriangledown	â–½
\circlearrowleft	â†º
\curvearrowright	â†·
\downleftharpoon	â‡ƒ
\leftharpoondown	â†½
\leftrightarrows	â‡†
\nLeftrightarrow	â‡
\nleftrightarrow	â†®
\ntrianglelefteq	â‹¬
\rightleftarrows	â‡„
\rightthreetimes	â‹Œ
\squigarrowright	â‡
\textinterrobang	â€½
\textmusicalnote	â™ª
\trianglerighteq	âŠµ
\vartriangleleft	âŠ²
\circlearrowright	â†»
\downrightharpoon	â‡‚
\ntrianglerighteq	â‹­
\rightharpoondown	â‡
\rightrightarrows	â‡‰
\twoheadleftarrow	â†
\vartriangleright	âŠ³
^\reversed open e	á¶Ÿ
\blacktriangledown	â–¾
\blacktriangleleft	â—‚
\leftrightharpoons	â‡‹
\rightleftharpoons	â‡Œ
\textcolonmonetary	â‚¡
\textreferencemark	â€»
\twoheadrightarrow	â† 
^\n with left hook	á¶®
^\u with left hook	ê­Ÿ
\Longleftrightarrow	â‡”
\blacktriangleright	â–¸
\longleftrightarrow	â†”
\textpertenthousand	â€±
\leftrightsquigarrow	â†­
\textfractionsolidus	â„
^\capital inverted r	Ê¶
^\turned r with hook	Êµ
^\j with crossed-tail	á¶¨
^\l with middle tilde	ê­
^\l with palatal hook	á¶ª
^\t with palatal hook	á¶µ
^\capital i with stroke	á¶§
^\dotless j with stroke	á¶¡
^\l with retroflex hook	á¶©
^\n with retroflex hook	á¶¯
^\reversed glottal stop	Ë¤
^\z with retroflex hook	á¶¼
^\l with inverted lazy s	ê­
^\turned m with long leg	á¶­
